{	
	"name": "Split Level",
	"width": 9,
	"height": 8,
	"active": [
	    [" "," "," "," "," "," "," "," "," "],
	    
	    [" ","B"," "," "," "," "," ","b"," "],
	    
	    [" "," "," "," "," "," "," "," "," "],
	    
	    [" "," "," "," "," "," "," "," "," "],
	    
	    [" "," "," "," "," "," "," "," "," "],
	    
	    [" "," "," "," "," "," "," "," "," "],
	    
	    [" "," "," "," "," "," "," "," "," "],
	    
	    [" "," "," "," "," "," "," "," "," "]
	],
	"fixed":[
	    ["#","#","#","#","#","#","#","#","#"],
	    
	    ["#"," "," "," ","#"," "," "," ","#"],
	    
	    ["#"," "," "," ","#"," "," "," ","#"],
	    
	    ["#","#","#"," ","#"," ","#","#","#"],
	    
	    ["#"," "," "," ","#"," ","#","g","#"],
	    
	    ["#"," ","#","#","#"," ","#"," ","#"],
	    
	    ["#"," "," ","G","#"," "," "," ","#"],
	    
	    ["#","#","#","#","#","#","#","#","#"]
	]
}