{
"name": "Exported Level",
"width": 9,
"height": 6,
"starLevels": [90,31,26],
"active": [
[" "," "," "," "," "," "," "," "," "],
[" "," "," "," "," "," "," "," "," "],
[" "," "," "," "," "," "," "," "," "],
[" ","@"," "," "," "," ","b"," "," "],
[" "," "," "," "," "," ","B"," "," "],
[" "," "," "," "," "," "," "," "," "]
],

"fixed": [
["#","#","#","#","#","#","#","#","#"],
["#","g","#"," "," "," ","#"," ","#"],
["#","G","#"," ","#"," ","#"," ","#"],
["#"," ","#"," ","#"," "," "," ","#"],
["#"," "," "," ","#"," "," ","#","#"],
["#","#","#","#","#","#","#","#","#"]
]


}