{
"name": "Exported Level",
"width": 7,
"height": 7,
"starLevels": [90,21,14],
"active": [
[" "," "," "," "," "," "," "],
[" "," "," "," "," "," "," "],
[" "," "," "," "," "," "," "],
[" "," "," "," "," "," "," "],
[" "," "," "," "," "," "," "],
[" ","B","b"," "," "," "," "],
[" "," "," "," "," "," "," "]
],

"fixed": [
["#","#","#","#","#","#","#"],
["#"," "," "," "," "," ","#"],
["#"," "," ","#"," ","#","#"],
["#"," ","#","#","#","#","#"],
["#"," "," ","#"," "," ","#"],
["#"," "," "," ","g","G","#"],
["#","#","#","#","#","#","#"]
]


}