{	
	"name": "Enemy Level 1",
	"width": 8,
	"height": 6,
	"active": [
	    
	    [" "," "," "," "," "," "," "," "],
	    
	    [" "," "," "," "," "," "," "," "],
	    
	    [" "," "," "," "," "," "," "," "],
	    
	    [" ","b"," "," "," "," "," "," "],

	    [" ","B"," "," "," "," "," "," "],

	    [" "," "," "," "," "," "," "," "]
	],
	"fixed": [
	    ["#","#","#","#","#","#","#","#"],
	    
	    ["#"," "," "," "," "," ","#","#"],
	    
	    ["#"," "," "," "," "," ","#","#"],
	    
	    ["#"," "," "," "," ","E","g","#"],

	    ["#"," "," "," "," ","E","G","#"],

	    ["#","#","#","#","#","#","#","#"]
	]
}