{	
	"name": "Enemy Level",
	"width": 10,
	"height": 10,
	"active": [
	    [" "," "," "," "," "," "," "," "," "," "],
	    
	    [" "," "," "," "," "," "," "," "," "," "],
	    
	    [" "," "," "," "," "," "," "," "," "," "],
	    
	    [" "," "," "," "," "," "," "," "," "," "],
	    
	    [" "," "," "," "," "," "," "," "," "," "],
	    
	    [" "," "," "," "," "," "," "," "," "," "],
	    
	    [" "," "," "," "," "," "," "," "," "," "],

	    [" "," "," "," "," "," "," "," "," "," "],
	    
	    [" "," "," "," "," ","b","B"," "," "," "],

	    [" "," "," "," "," "," "," "," "," "," "]
	],
	"fixed": [
	    ["#","#","#","#","#","#","#","#","#","#"],
	    
	    ["#","#"," "," "," "," "," "," "," ","#"],
	    
	    ["#","#"," "," "," "," "," ","E","E","#"],

	    ["#","#","#","#"," "," ","#","g","G","#"],

	    ["#"," "," ","E"," "," ","#","#","#","#"],        
	    
	    ["#"," "," ","#"," "," ","E"," "," ","#"],
	    
	    ["#"," "," ","#","#","#","#"," "," ","#"],
	    
	    ["#"," "," "," "," "," "," "," "," ","#"],
	    
	    ["#"," "," ","#","#"," "," "," "," ","#"],
	    
	    ["#","#","#","#","#","#","#","#","#","#"]
	]
}