{	
	"name": "Gate Level",
	"width": 10,
	"height": 11,
	"active": [
	    [" "," "," "," "," "," "," "," "," "," "],
	    
	    [" ","b"," "," "," "," "," "," ","B"," "],
	    
	    [" "," "," "," "," "," "," "," "," "," "],
	    
	    [" "," "," "," "," "," "," "," "," "," "],
	    
	    [" "," "," "," "," "," "," "," "," "," "],
	    
	    [" "," "," "," "," "," "," "," "," "," "],
	    
	    [" "," "," "," "," "," "," "," "," "," "],

	    [" "," "," "," "," "," "," "," "," "," "],
	    
	    [" "," "," "," "," "," "," "," "," "," "],

	    [" "," "," "," "," "," "," "," "," "," "],
	    
	    [" "," "," "," "," "," "," "," "," "," "]
	],
	"fixed":[
	    ["#","#","#","#","#","#","#","#","#","#"],
	    
	    ["#"," "," "," "," ","#"," ","3"," ","#"],
	    
	    ["#"," ","#","#"," "," "," ","3","3","#"],
	    
	    ["#"," ","#"," "," "," "," "," "," ","#"],
	    
	    ["#"," "," "," ","#","7","#"," "," ","#"],
	    
	    ["#","#"," "," ","7","G","7"," "," ","#"],
	    
	    ["#"," "," "," ","#","7","#"," ","#","#"],
	    
	    ["#"," ","1"," "," "," "," "," "," ","#"],
	    
	    ["#"," "," "," ","5"," "," "," "," ","#"],
	    
	    ["#"," "," "," "," ","g"," "," "," ","#"],
	    
	    ["#","#","#","#","#","#","#","#","#","#"]             
	]
}