{	
	"name": "Gate Level",
	"width": 9,
	"height": 10,
	"active": [
	    [" "," "," "," "," "," "," "," "," "],
	    
	    [" ","b"," "," "," "," "," ","B"," "],
	    	    
	    [" "," "," "," "," "," "," "," "," "],
	    
	    [" "," "," "," "," "," "," "," "," "],
	    
	    [" "," "," "," "," "," "," "," "," "],
	    
	    [" "," "," "," "," "," "," "," "," "],

	    [" "," "," "," "," "," "," "," "," "],
	    
	    [" "," "," "," "," "," "," "," "," "],

	    [" "," "," "," "," "," "," "," "," "],
	    
	    [" "," "," "," "," "," "," "," "," "]
	],
	"fixed":[	    
	    ["#","#","#","#","#","#","#","#","#"],
	    
	    ["#"," "," "," "," "," ","3"," ","#"],
	    
	    ["#"," ","#"," "," "," ","3","3","#"],
	    
	    ["#"," "," "," ","#"," "," "," ","#"],
	    
	    ["#","#"," "," "," "," "," "," ","#"],
	    
	    ["#"," "," "," ","#"," "," ","#","#"],
	    
	    ["#"," ","1"," "," "," "," ","G","#"],
	    
	    ["#"," "," "," ","5"," "," ","g","#"],
	    
	    ["#"," "," "," "," "," "," "," ","#"],
	    
	    ["#","#","#","#","#","#","#","#","#"]             
	]
}