{	
	"name": "Gate Level",
	"width": 10,
	"height": 11,
	"active": [
	    [" "," "," "," "," "," "," "," "," "," "],
	    
	    [" ","b"," "," "," "," "," "," ","B"," "],
	    
	    [" "," "," "," "," "," "," "," "," "," "],
	    
	    [" "," "," "," "," "," "," "," "," "," "],
	    
	    [" "," "," "," "," "," "," "," "," "," "],
	    
	    [" "," "," "," "," "," "," "," "," "," "],
	    
	    [" "," "," "," "," "," "," "," "," "," "],

	    [" "," "," "," "," "," "," "," "," "," "],
	    
	    [" "," "," "," "," "," "," "," "," "," "],

	    [" "," "," "," "," "," "," "," "," "," "],
	    
	    [" "," "," "," "," "," "," "," "," "," "]
	],
	"fixed":[
	    ["#","#","#","#","#","#","#","#","#","#"],
	    
	    ["#"," "," "," "," ","#"," ","2"," ","#"],
	    
	    ["#"," ","#","#"," "," "," ","2","2","#"],
	    
	    ["#"," ","#"," "," "," "," "," "," ","#"],
	    
	    ["#"," "," "," ","#","5","#"," "," ","#"],
	    
	    ["#","#"," "," ","5","G","5"," "," ","#"],
	    
	    ["#"," "," "," ","#","5","#"," ","#","#"],
	    
	    ["#"," ","1"," "," "," "," "," "," ","#"],
	    
	    ["#"," "," "," ","4"," "," "," "," ","#"],
	    
	    ["#"," "," "," "," ","g"," "," "," ","#"],
	    
	    ["#","#","#","#","#","#","#","#","#","#"]             
	]
}