{	
	"name": "Passage Level",
	"width": 8,
	"height": 6,
    "starLevels":[16,11],
	"active": [
	    
	    [" "," "," "," "," "," "," "," "],
	    
	    [" ","b"," "," "," "," "," "," "],
	    
	    [" "," "," "," "," "," "," "," "],
	    
	    [" "," "," "," "," "," "," "," "],
	    
	    [" "," "," ","B"," "," "," "," "],

	    [" "," "," "," "," "," "," "," "]
	],
	"fixed":[
	    
	    ["#","#","#","#","#","#","#","#"],
	    
	    ["#"," "," ","0","0"," "," ","#"],
	    
	    ["#"," ","#"," ","G","#"," ","#"],
	    
	    ["#"," ","#","#"," "," "," ","#"],
	    
	    ["#","g","#"," "," "," "," ","#"],
	    
	    ["#","#","#","#","#","#","#","#"]
	]
}