{	
	"name": "Split Level",
	"width": 9,
	"height": 7,
	"starLevels": [13,8],
	"tutorial": [
		"tutorial1",
        "tutorial2",
        "tutorial3"
	],
	"active": [
	    [" "," "," "," "," "," "," "," "," "],
	    
	    [" ","B"," "," "," "," "," ","b"," "],
	    
	    [" "," "," "," "," "," "," "," "," "],
	    
	    [" "," "," "," "," "," "," "," "," "],
	    
	    [" "," "," "," "," "," "," "," "," "],
	    
	    [" "," "," "," "," "," "," "," "," "],
	    
	    [" "," "," "," "," "," "," "," "," "]
	],
	"fixed":[
	    ["#","#","#","#","#","#","#","#","#"],
	    
	    ["#"," "," "," ","#"," "," "," ","#"],
	    
	    ["#","#","#"," ","#"," ","#"," ","#"],
	    
	    ["#"," "," "," ","#"," ","#","#","#"],
	    
	    ["#"," ","#","#","#"," ","#","g","#"],
	    
	    ["#"," "," ","G","#"," "," "," ","#"],
	    
	    ["#","#","#","#","#","#","#","#","#"]
	]
}