{	
	"name": "Start Level",
	"width": 9,
	"height": 8,
	"active": [
	    [" "," "," "," "," "," "," "," "," "],
	    
	    [" ","b","B"," "," "," "," "," "," "],
	    
	    [" "," "," "," "," "," "," "," "," "],
	    
	    [" "," "," "," "," "," "," "," "," "],
	    
	    [" "," "," "," "," "," "," "," "," "],
	    
	    [" "," "," "," "," "," "," "," "," "],
	    
	    [" "," "," "," "," "," "," "," "," "],
	    
	    [" "," "," "," "," "," "," "," "," "]
	],
	"fixed":[
	    ["#","#","#","#","#","#","#","#","#"],
	    
	    ["#"," "," ","#"," "," "," "," ","#"],
	    
	    ["#"," "," ","#"," "," "," "," ","#"],
	    
	    ["#"," "," "," "," "," "," "," ","#"],
	    
	    ["#","#","#"," "," "," ","#","#","#"],
	    
	    ["#","g","G"," "," "," "," "," ","#"],
	    
	    ["#","#","#","#"," "," "," "," ","#"],
	    
	    ["#","#","#","#","#","#","#","#","#"]
	]
}