{	
	"name": "Start Level 4",
	"width": 8,
	"height": 6,
	"active": [
	    [" "," "," "," "," "," "," "," "],
	    
	    [" ","b","B"," "," "," "," "," "],
	    
	    [" "," "," "," "," "," "," "," "],
	    	    
	    [" "," "," "," "," "," "," "," "],
	    
	    [" "," "," "," "," "," "," "," "],
	    
	    [" "," "," "," "," "," "," "," "]
	],
	"fixed":[
	    ["#","#","#","#","#","#","#","#"],
	    
	    ["#"," "," ","#","#","#","G","#"],
	    	    
	    ["#"," "," "," "," ","#"," ","#"],
	    
	    ["#","#","#"," "," ","#"," ","#"],
	    
	    ["#","g"," "," "," "," "," ","#"],
	     
	    ["#","#","#","#","#","#","#","#"]
	]
}