{	
	"name": "Start Level 1",
	"width": 8,
	"height": 6,
	"active": [
	    [" "," "," "," "," "," "," "," "],
	    
	    [" ","b","B"," "," "," "," "," "],
	    
	    [" "," "," "," "," "," "," "," "],
	    	    
	    [" "," "," "," "," "," "," "," "],
	    
	    [" "," "," "," "," "," "," "," "],
	    
	    [" "," "," "," "," "," "," "," "]
	],
	"fixed":[
	    ["#","#","#","#","#","#","#","#"],
	    
	    ["#"," "," "," "," "," "," ","#"],
	    	    
	    ["#","#","#","#","#"," "," ","#"],
	    
	    ["#","G"," "," "," "," "," ","#"],
	    
	    ["#","g"," "," "," "," ","#","#"],
	     
	    ["#","#","#","#","#","#","#","#"]
	]
}