{
"name": "Exported Level",
"width": 10,
"height": 7,

"active": [
[" "," "," "," "," "," "," "," "," "," "],
[" "," "," "," "," "," "," "," "," "," "],
[" "," "," "," "," "," "," "," "," "," "],
[" "," "," "," "," "," "," "," "," "," "],
[" "," "," "," "," "," "," "," "," "," "],
["b","B"," "," "," "," "," "," "," "," "],
[" "," "," "," "," "," "," "," "," "," "]
],

"fixed": [
[" "," "," "," "," "," "," "," "," "," "],
[" ","#"," ","#","#","#","#","#"," "," "],
[" "," "," ","#"," "," "," "," "," "," "],
["#","#","#","#"," "," ","#","#","#","#"],
["G","g","#","#"," "," "," "," "," "," "],
[" "," ","#","#","#","#","#","#"," "," "],
[" "," "," "," "," "," "," "," "," "," "]
]


}