{
"name": "Exported Level",
"width": 10,
"height": 7,

"active": [
[" "," "," "," "," "," "," "," "," "," "],
[" "," "," "," "," "," "," "," "," "," "],
[" "," "," "," "," "," "," ","$"," "," "],
[" "," "," "," "," "," "," ","@"," "," "],
[" "," "," "," "," "," "," "," "," "," "],
[" "," "," "," "," "," "," "," "," "," "],
[" "," "," "," "," "," "," "," "," "," "]
],

"fixed": [
["+"," "," "," "," "," "," ","3"," ","E"],
["+"," "," "," "," "," "," "," "," "," "],
[" "," "," "," "," "," "," "," "," "," "],
["3"," "," "," "," "," "," "," "," "," "],
[" "," "," "," "," "," "," "," "," "," "],
[" "," "," "," "," "," "," "," "," "," "],
[" "," "," "," "," "," "," "," "," "," "]
]

}