{	
	"name": "Test Level",
	"width": 8,
	"height": 6,
	"starLevels": [9,4],	
	"active": [
	    [" "," "," "," "," "," "," "," "],
	    
	    [" ","b","B"," "," "," "," "," "],
	    
	    [" "," "," "," "," "," "," "," "],
	    	    
	    [" "," "," "," "," "," "," "," "],
	    
	    [" "," "," "," "," "," "," "," "],
	    
	    [" "," "," "," "," "," "," "," "]
	],
	"fixed":[
	    ["#","#","#","#","#","#","#","#"],
	    
	    ["#"," "," "," "," ","+","g","#"],
	    	    
	    ["#"," "," "," "," "," ","G","#"],
	    
	    ["#"," ","+"," "," ","+","+","#"],
	    
	    ["#","+"," "," "," "," "," ","#"],
	     
	    ["#","#","#","#","#","#","#","#"]
	]
}