{
"name": "Exported Level",
"width": 11,
"height": 8,
"starLevels": [18,13],
"active": [
[" "," "," "," "," "," "," "," "," "," "," "],
[" "," ","B"," "," "," "," "," "," "," "," "],
[" "," "," "," "," "," "," "," "," "," "," "],
[" ","b"," "," "," "," "," "," "," "," "," "],
[" "," "," "," "," "," "," "," "," "," "," "],
[" "," "," "," "," "," "," "," "," "," "," "],
[" "," "," "," "," "," "," "," "," "," "," "],
[" "," "," "," "," "," "," "," "," "," "," "]
],

"fixed": [
["#","#","#","#","#","X","X","X","X","X","X"],
["#"," "," "," "," "," "," "," ","+","X","X"],
["#"," ","#"," ","#"," "," "," "," "," ","X"],
["#"," "," "," ","#"," ","+"," "," "," ","+"],
["#","3","#","#","#"," "," ","+"," "," ","X"],
["X"," "," "," ","+","1"," "," "," "," ","X"],
["X"," "," "," "," "," "," ","G","g","+","X"],
["#","#","X","X","X","+","X","X","X","X","X"]
]


}