{	
	"name": "Test Level",
	"width": 8,
	"height": 7,
	"starLevels": [11,6],
	"active": [
	    [" "," "," "," "," "," "," "," "],
	    
	    [" ","b","B"," "," "," "," "," "],
	    
	    [" "," "," "," "," "," "," "," "],
	    	    
	    [" "," "," "," "," "," "," "," "],
	    
	    [" "," "," "," ","$"," "," "," "],
	    
	    [" "," "," "," "," "," "," "," "],

	    [" "," "," "," "," "," "," "," "]
	],
	"fixed":[
	    ["#","#","#","#","#","#","#","#"],
	    
	    ["#"," "," "," "," "," ","g","#"],
	    	    
	    ["#","#"," "," "," "," ","G","#"],
	    
	    ["#"," "," "," "," ","#"," ","#"],
	    
	    ["#"," "," "," "," "," "," ","#"],

	    ["#"," "," "," "," "," ","#","#"],
	     
	    ["#","#","#","#","#","#","#","#"]
	]
}