{
"name": "Exported Level",
"width": 12,
"height": 9,
"starLevels": [22,17],
"active": [
[" "," "," "," "," "," "," "," "," "," "," "," "],
[" "," "," "," "," "," "," "," "," "," "," "," "],
[" "," "," "," "," "," "," "," "," "," "," "," "],
[" "," "," "," ","$"," "," "," "," "," "," "," "],
[" "," "," "," "," "," "," "," "," "," "," "," "],
[" "," ","b"," "," "," "," "," "," "," "," "," "],
[" "," ","B"," "," "," "," "," "," "," "," "," "],
[" "," "," "," "," "," "," "," "," "," "," "," "],
[" "," "," "," "," "," "," "," "," "," "," "," "]
],

"fixed": [
["#","#","#","#","#","#","#","#","#","#","#","#"],
["#","g","G"," "," "," "," "," ","#"," "," ","#"],
["#"," ","#","#","#"," "," "," "," "," "," ","#"],
["#"," "," "," "," "," "," ","#"," "," "," ","#"],
["#"," "," "," "," ","#"," "," "," "," "," ","#"],
["#"," "," "," "," "," "," "," "," ","#"," ","#"],
["#"," "," "," "," "," ","#"," "," "," "," ","#"],
["#","#"," "," "," "," "," "," "," "," "," ","#"],
["#","#","#","#","#","#","#","#","#","#","#","#"]
]

}