{
"name": "Exported Level",
"width": 10,
"height": 7,

"active": [
[" "," "," "," "," "," "," "," "," "," "],
[" "," "," "," "," "," "," "," "," "," "],
[" "," "," "," "," "," "," "," "," "," "],
[" "," "," "," "," "," "," "," "," "," "],
[" "," "," "," "," "," "," "," "," "," "],
[" "," ","B","b"," "," "," "," "," "," "],
[" "," "," "," "," "," "," "," "," "," "]
],

"fixed": [
[" ","#","#","#","#","#","#","#"," "," "],
[" ","#"," "," "," "," "," ","#"," "," "],
[" ","#"," "," ","#"," ","#","#"," "," "],
[" ","#"," ","#","#","#","#","#"," "," "],
[" ","#"," "," ","#"," "," ","#"," "," "],
[" ","#"," "," "," ","g","G","#"," "," "],
[" ","#","#","#","#","#","#","#"," "," "]
]


}