{	
	"name": "Test Level",
	"width": 8,
	"height": 6,
	"starLevels": [20,10],
	"active": [
	    [" "," "," "," "," "," "," "," "],
	    
	    [" ","b","B"," "," "," "," "," "],
	    
	    [" "," "," "," "," "," "," "," "],
	    	    
	    [" "," "," "," "," "," "," "," "],
	    
	    [" "," "," "," "," ","@"," "," "],
	    
	    [" "," "," "," "," "," "," "," "]
	],
	"fixed":[
	    ["#","#","#","#","#","#","#","#"],
	    
	    ["#"," "," "," "," "," ","g","#"],
	    	    
	    ["#"," "," "," "," "," ","G","#"],
	    
	    ["#"," ","#"," "," "," "," ","#"],
	    
	    ["#"," "," "," "," "," "," ","#"],
	     
	    ["#","#","#","#","#","#","#","#"]
	]
}