{
"name": "Exported Level",
"width": 9,
"height": 7,
"starLevels": [16,11],
"active": [
	[" "," "," "," "," "," "," "," "," "],
	[" "," "," ","$"," "," "," "," "," "],
	[" "," "," "," "," "," "," "," "," "],
	[" "," "," "," "," ","b"," "," "," "],
	[" "," "," "," "," ","B"," "," "," "],
	[" "," "," "," "," "," "," "," "," "],
	[" "," "," "," "," "," "," "," "," "]
],

"fixed": [
	["#","#","#","#","#","#","#","#","#"],
	["#"," ","#"," "," ","#"," "," ","#"],
	["#","G"," "," "," "," "," "," ","#"],
	["#","g"," "," "," "," "," "," ","#"],
	["#","#"," "," ","#"," "," "," ","#"],
	["#","#","#","#","#"," "," "," ","#"],
	["#","#","#","#","#","#","#","#","#"]
]


}