{
"name": "Exported Level",
"width": 8,
"height": 6,
"starLevels": [21,16],
"active": [
[" "," "," "," "," "," "," "," "],
[" ","B","b"," "," "," "," "," "],
[" "," "," "," "," "," "," "," "],
[" "," "," "," "," "," "," "," "],
[" "," "," "," "," "," "," "," "],
[" "," "," "," "," "," "," "," "]
],

"fixed": [
["#","#","#","#","#","#","#","#"],
["#"," "," ","0","#","+","g","#"],
["#"," "," "," ","+","+","#","#"],
["#"," "," ","0","0","0","G","#"],
["#"," "," "," "," "," "," ","#"],
["#","#","#","#","#","#","#","#"]
]


}