{
"name": "Exported Level",
"width": 8,
"height": 6,
"starLevels": [28,23],
"active": [
[" "," "," "," "," "," "," "," "],
[" ","B","b"," "," "," "," "," "],
[" "," "," "," "," "," "," "," "],
[" "," "," "," "," "," "," "," "],
[" "," "," "," "," "," "," "," "],
[" "," "," "," "," "," "," "," "]
],

"fixed": [
["#","#","#","#","#","#","#","#"],
["#"," "," ","#","g","G"," ","#"],
["#"," ","0","#"," "," "," ","#"],
["#","+","+","3","1"," "," ","#"],
["#"," "," "," ","0"," ","#","#"],
["#","#","#","#","#","#","#","#"]
]


}